8888888888888888888
8.D. . 8 . . . .888
8 . . .8. .888. . 8
8. . . . M . . . .8
8 . . .8888 . . . 8
8. 8 . 8888. . . .8
888 . . . . .888. 8
8. .M. . . . 8 . .8
8 . . .8888 . M . 8
8888888888888888888