88888888888888888888888888888
8M.M.M.M.M.M.M.M.M.M.M.M.M.M8
8.M.M.M.M.M.M.M.M.M.M.M.M.M.8
8M.M.M.M.M.M.M.M.M.M.M.M.M.M8
8.M.M.M.M.M.M.M.M.M.M.M.M.M.8
8M.M.M.M.M.M.....M.M.M.M.M.M8
8.M.M.M.M.M...D...M.M.M.M.M.8
8M.M.M.M.M.M.....M.M.M.M.M.M8
8.M.M.M.M.M.M.M.M.M.M.M.M.M.8
8M.M.M.M.M.M.M.M.M.M.M.M.M.M8
8.M.M.M.M.M.M.M.M.M.M.M.M.M.8
8M.M.M.M.M.M.M.M.M.M.M.M.M.M8
8.M.M.M.M.M.M.M.M.M.M.M.M.M.8
8M.M.M.M.M.M.M.M.M.M.M.M.M.M8
88888888888888888888888888888
