8888888888888888888
8.D. . . . . 888 .8
888 . . . . . 88. 8
88 . . . 888 .M. .8
8 . . . . 8888. . 8
8. . 88. .M. 88. .8
88888 . . . . . . 8
8 . .M. 8888. . . 8
8. . . . . . .88 .8
8888888888888888888