888888888888888888888888
8888888888..88888888...8
88...D.......8888888....
88...........8888888888.
88...88888..............
88...88888..............
88...........8888....888
88...........88888...888
88888..8888..888888...88
88888..8888..88888888...
88888..8888.............