88888888888888888888888888888
8.D. . 8 . . . . . . . 888 .8
8 . . .8. .888. . . . . 88. 8
8. . . . . .M. . . 888M. . .8
8 . . . 888 . . . . 8888. . 8
8.M8 . 8888. . 88. . . 88. .8
888 . .8. . .88 . .888.888. 8
8. . . . . . .M. . . . 88. .8
8 . . .8888 . . . .88 . 8 . 8
8. .88 . . . . . . . . . . .8
8 . . . . 88888 . . . . .M. 8
8. 88. . . . . . . .888. . .8
8 . .M. . . . . . .888. . . 8
88888. . 88. . . . . . . 8 .8
88888888888888888888888888888